                SO      ./assests/textures/1.xpm
NO               ./assests/textures/2.xpm
                       
EA ./assests/textures/3.xpm
               
WE ./assests/textures/4.xpm

F 255,255,0

C 0,0,0


                                                     1111111111111111111111111111111111111111111111111
                                                       100000000001000000000000000000000000000000000011111
        1111111111111111111111111111111111111111      11111000000000000000000000000000000000000000000000011
 11111110000000000000000000000111   11111            1000000000000000000000000000000000000000000000001111
 10000000000000000011110000000000111   1111111111     1000010000000000000000000000000000000000000000000011
 1100000000000000001  1000000000001   1100000001     10000000010100000000000000000000000000000000000000111
 1111111111111111111  11111110111111   1111111101     100000001010100000000000000000000000000000000000000011
                           10001               101     100000000000000000000000001000000000000000000000000011
 11111111111111111     111110001111111111111   101111  1000000000000000000000000111000000000000000000000000011
 11000000000000011    1100000000000000000001   100001  10000000000000000000000011 11000000000000000000000000011
 10000000000000001    1000000000000000000001   1100011 1000000000000000000000011   11000000000000000000000000011
 11000000000000011    1100000000000111110001   1000001 10000000000000000000000011 11000000000000000000000000011
 1000000000000001      1000000000001   10001   1000001 1000000000000000000000000111000000000000000000000000011
 11100000000000011111111000000000001   10001   11000011100000000000000000000000001000000000000000000000000011
  1111000000000000001000000000000001   10001  11100000000000000000000000000000000000000000000000000000000011
  1100000000000000000000000001111111   11111  1000111111000000000000000000000000000000000000000000000000011
  11111000001100000000000000000001           10001    100000000000000000000000000000000000000000000000011
111000000000000000000000000001111111111111111110001    1000000000000000000000000000000000000000000000001
111111000000000000000000000000000000000000000000001    1000000000000000000000000000000000000000000000011
    11111100000000000000000011111111111111111000001    10000000000000000000000000000000000000000000011
        1111110000000000111111            111111111    100000000000000000W0000000000000000000000000011
            11111111001111111111                       1000000000000000000000000000000000000000000011
                  110011                               111111111111111111111111111111111111111111111
                  110011                     11111111111
                  110011                     10000000001
                  110011                     10011110001
                  110011                     1001  10001
             11111110011111111111111111111111100111100011111111111111111111111111
             10000000000000000000000000000000000000000000000000000000000011
             10000000000000000000011111111111111111000000000000000000000011
             1111100000000000000001               1000000000000000000000011
                 100000000000000001               1000000111111111111111111
    111111111111110001111111111111111111111111111110000011
    110000000000000000000000000000000000000000000000000011       11111111111111111
    110000000000000000000000000000000000000000000000000011       10000000000000001
    110000000000000000000000000000000000000000000000000011111111110000000000000001
    110000000000000000000000000000000000000000000000000000000000000000000000000001
    110000000000000000000000000000000000000000000000000000000000000000000000000001
    110000000000000000000000000000000000000000000000000011111111110000000000000001
    110000000000000000000000000000000000000000000000000011       1000000000000000111111111
    110000000000000000000000000000000000000000000000000011       1000000000000000000000001
    110000000000000000000000000000000000000000000000000011   11111000000000000000000000001
    110000000000000000000000000000000000000000000000000011   10000000000000000000000000001
    110000000000000000000000000000000000000000000000000011   10000000000000000000000000001
    110000000000000000000000000000000000000000000000000011   11111111111111111111111111111
    111111111111111111111111111111111111111111111111111111
